E#####C#$$$$#####$$$ 
$##$$$$$$##$$$$##M#$ 
$$$$##$##$$$##$###$$ 
####C##$$$####$$#$$# 
#$$$$##$M$$$$##$$$## 
#$#####$$$##$###$### 
#$######$###$$$$$$$M 
$M$$$##$$##########$ 
$###$$##$$$$#C$####$ 
$####$$$$##$$#$$$$#$ 
$$$$####$###M####$#$ 
###M###$$#$$$$$$#C$$ 
##$$$######$###$#### 
#$$#$#$##M$$###$#### 
#$##$$$########$#### 
#$$#$#####$##$$M$$$$ 
#$##C$$$$$$#$$###$#$ 
######$#$#$$$####$## 
#$$$$#$##$##$#$$$M$# 
C$##$$$##$$$$$$###$S 